









                                                                                                                                    11, 7, 1,   12, 7, 1,   13, 7, 1,

                                                                                                                                    11, 6, 0,   12, 6, 0,

                                                                                                                                    11, 5, 0,   12, 5, 0,

0, 4, 1,	1, 4, 1,	2, 4, 1,	3, 4, 1,	4, 4, 1,	5, 4, 1,	6, 4, 1,	7, 4, 1,	8, 4, 1,	9, 4, 1,	10, 4, 1,	11, 4, 0,	12, 4, 0,	13, 4, 1,	14, 4, 1,	15, 4, 1,	16, 4, 1,	17, 4, 1,	18, 4, 1,	19, 4, 1,	20, 4, 1,

0, 3, 0,	1, 3, 0,	2, 3, 0,	3, 3, 0,	4, 3, 0,	5, 3, 0,	6, 3, 0,	7, 3, 0,	8, 3, 0,	9, 3, 0,	10, 3, 0,	11, 3, 0,	12, 3, 0,	13, 3, 0,	14, 3, 0,	15, 3, 0,	16, 3, 0,	17, 3, 0,	18, 3, 0,	19, 3, 0,	20, 3, 0,

0, 2, 0,	1, 2, 0,	2, 2, 0,	3, 2, 0,	4, 2, 0,	5, 2, 0,	6, 2, 0,	7, 2, 0,	8, 2, 0,	9, 2, 0,	10, 2, 0,	11, 2, 0,	12, 2, 0,	13, 2, 0,	14, 2, 0,	15, 2, 0,	16, 2, 0,	17, 2, 0,	18, 2, 0,	19, 2, 0,	20, 2, 0,

0, 1, 0,	1, 1, 0,	2, 1, 0,	3, 1, 0,	4, 1, 0,	5, 1, 0,	6, 1, 0,	7, 1, 0,	8, 1, 0,	9, 1, 0,	10, 1, 0,	11, 1, 0,	12, 1, 0,	13, 1, 0,	14, 1, 0,	15, 1, 0,	16, 1, 0,	17, 1, 0,	18, 1, 0,	19, 1, 0,	20, 1, 0,

0, 0, 0,	1, 0, 0,	2, 0, 0,	3, 0, 0,	4, 0, 0,	5, 0, 0,	6, 0, 0,	7, 0, 0,	8, 0, 0,	9, 0, 0,	10, 0, 0,	11, 0, 0,	12, 0, 0,	13, 0, 0,	14, 0, 0,	15, 0, 0,	16, 0, 0,	17, 0, 0,	18, 0, 0,	19, 0, 0,	20, 0, 0